..........
.########.
.#......#.
.#......#.
.#......#.
.#..@...#.
.#......#.
.#......#.
.########.
..........