.#.#.#.#.#.#.#.#
#.#.#.#.#.#.#.#.
.#.#.#.@.#.#.#.#
#.#.#.#.#.#.#.#.
.#.#.#.#.#.#.#.#