.........
.........
.........
...#.#...
....@....
...#.....
#.......#
#.......#
###...###